+:....:::::::::::::::::::::::..::--========-:::::::::::::::::::::::::::::::::::+
=...........................:-==++++**********+=-:.::::::::::::::::::::::::::::+
=........................::-==++*****************+:....::::::::::::::::::::::::+
=......................::-=+***********************=--::.............:::::::..:+
=.....................:-==++**+++++++++++++++++*******+=:......................+
+::::...............:-====+++++++++=+++++++++++***####**+-.....................+
+:::::::::::::::::::==+++++++============+++++++**#####**+:...:::::::....:..:::+
+..................=++++++++==============++++++**####****-::::::::::::::::::::+
*---========---==--=+++++++++===+=+==+++++++++++**#####**+:::::::::::::::::::::+
#+++++++++==========+==++++===+======+++++++++++**#####*+==============++======*
#+++++++++============+++++++++++++++++++++++++++**####*+===+==================*
#===============+====+**####**+++***##****++++++++*##****+=+++==++==========+++#
#++=++++=============+*****#**+++***********++++++++++++*+========--========+++*
*-------=====---=====+++****+++++++++++++++++++++++++***+======---===========+=*
*---------------::::=++++*++++++++++++++===++++++++++**+:---------===========++*
*==--------===-==---=++****++++++++***+++=++=++++++++++-:------======++++====++#
*=============------=**#****+*******++***+++++++++++++=--==----====++++++==++++#
*====+++++=+=========***#***+*************+++++++++++=--=====--====+++*+++++===*
+-------==-==--------=*****#*+**++++*#*+++++++++++++---==============+++=======*
*----------------------+**+++++*+++++++++++++++++++------=---=---=-====----====*
*-====------------------=+**+*+++++++++++++++++++++=-----=---==--========----==*
#+===--===---==------==---++++++++++++++++++++++++**#*---------=====-----------*
*=====================----:=*************+++++++*#%%%%=------==---=====--=-----*
+-----------------------::--++*********+++++++*#%%%%%%*------==----======++====*
+-----------------------::=#++++++++++++++++#%%%%%%%%%%*======--=-=-====-======*
+--------:----------:::::*%%+++++++++++++*#%%%%%%%%%%%%%%*=:::::------:-----:--*
+-:-:---::::-----:--=+*##%%%*=+++++++=+*#%%%%%%%%%%%%%%%%%%#+-:-----::-:-------+
*--------:::::-=+*####**##%%#++++++=+#%%%%%%%%%%%%%%%%%%%%%%##*=---------------*
*---::-----+*###########%@%%%#*++**#%%%%%%%%%%%%%%%%%%%%%%%%%####+=-:----------*
+------::+%############%%%%%###%%%%%%%%%%%%%%%%%%%%%%%%%%%%%%%%#####+=---------*
*=------#%%################%%%%%%%%%%%%%%%%%%%%######%%%%%%%%%%%%#####*=-:-----*
+-----:+%%################%%%%%%%%%%%####################%%%%%%%%%%%%%%##+-----*
+---:::##################%#*#%##############################%%%%%%%%%%%%##*----+
*----:*%###################%###############################%%%%%%%%%%%%%%##*---+
